TP53	Myeloid_AYA,Lymphoid_OA
HIF1A	Myeloid_AYA,Lymphoid_OA
PIK3R1	Myeloid_AYA,Lymphoid_AYA
GRB2	Myeloid_AYA
SIRT1	Myeloid_AYA,Myeloid_OA,Lymphoid_AYA,Lymphoid_OA
CDK2	Myeloid_AYA,Lymphoid_OA
APEX1	Myeloid_AYA
KRT40	Myeloid_AYA
PLCG1	Myeloid_AYA,Lymphoid_AYA
DVL3	Myeloid_AYA,Myeloid_OA
RELA	Myeloid_AYA,Lymphoid_OA
TP73	Myeloid_AYA
ASH2L	Myeloid_AYA,Myeloid_OA,Lymphoid_OA
DDX5	Myeloid_AYA,Myeloid_OA,Lymphoid_OA
TET2	Myeloid_AYA
POU3F2	Myeloid_AYA
NBN	Myeloid_AYA
HIPK2	Myeloid_AYA,Myeloid_OA,Lymphoid_OA
PIK3R2	Myeloid_AYA
GRB7	Myeloid_AYA
FUS	Myeloid_AYA
CRK	Myeloid_AYA
BRD7	Myeloid_AYA,Myeloid_OA,Lymphoid_OA
EWSR1	Myeloid_AYA
C3orf62	Myeloid_AYA,Lymphoid_OA
ZRANB1	Myeloid_AYA
WTAP	Myeloid_AYA
TGFBR2	Myeloid_AYA,Lymphoid_AYA
SQSTM1	Myeloid_AYA
PICK1	Myeloid_AYA
PECAM1	Myeloid_AYA,Lymphoid_AYA
OSBPL3	Myeloid_AYA
KRTAP10-8	Myeloid_AYA
KRTAP10-6	Myeloid_AYA
IPO8	Myeloid_AYA
HRAS	Myeloid_AYA
FGFR3	Myeloid_AYA,Myeloid_OA,Lymphoid_AYA,Lymphoid_OA
RUNX3	Myeloid_AYA
DNAJB1	Myeloid_AYA
CYSRT1	Myeloid_AYA
COPS2	Myeloid_AYA
CHAT	Myeloid_AYA,Lymphoid_AYA
BHLHE40	Myeloid_AYA,Myeloid_OA,Lymphoid_OA
APP	Myeloid_AYA,Lymphoid_OA
VDR	Myeloid_AYA,Myeloid_OA,Lymphoid_OA
KITLG	Myeloid_AYA
NCOA3	Myeloid_AYA,Lymphoid_OA
NAP1L1	Myeloid_AYA,Lymphoid_OA
ESR1	Myeloid_AYA,Myeloid_OA,Lymphoid_OA
DYRK1B	Myeloid_AYA,Lymphoid_OA
TCL1A	Myeloid_AYA,Myeloid_OA,Lymphoid_OA
SNAI1	Myeloid_AYA,Myeloid_OA,Lymphoid_OA
SKP2	Myeloid_AYA
KAT2B	Myeloid_AYA,Lymphoid_OA
TFAP2A	Myeloid_AYA
EP300	Myeloid_OA,Lymphoid_OA
USP7	Myeloid_OA,Lymphoid_OA
UBC	Myeloid_OA,Lymphoid_AYA,Lymphoid_OA
CREBBP	Myeloid_OA,Lymphoid_OA
SETD7	Myeloid_OA,Lymphoid_OA
RCHY1	Myeloid_OA,Lymphoid_OA
BCL2L1	Myeloid_OA,Lymphoid_OA
S100A4	Myeloid_OA,Lymphoid_OA
PIN1	Myeloid_OA,Lymphoid_AYA,Lymphoid_OA
TP53BP1	Myeloid_OA,Lymphoid_AYA,Lymphoid_OA
TWIST1	Myeloid_OA,Lymphoid_OA
PTPN1	Myeloid_OA
SMYD2	Myeloid_OA,Lymphoid_OA
PPP1R13L	Myeloid_OA,Lymphoid_OA
HSPA9	Myeloid_OA,Lymphoid_OA
SRPK2	Myeloid_OA
BAP1	Myeloid_OA
SDCBP2	Myeloid_OA
DVL2	Myeloid_OA,Lymphoid_OA
UBE3A	Myeloid_OA,Lymphoid_OA
VRK1	Myeloid_OA,Lymphoid_OA
PTK2	Myeloid_OA,Lymphoid_OA
PARP1	Myeloid_OA,Lymphoid_OA
UBE2I	Myeloid_OA,Lymphoid_OA
PLK1	Myeloid_OA,Lymphoid_OA
HMGB1	Myeloid_OA,Lymphoid_OA
MAGEA2	Myeloid_OA,Lymphoid_OA
SUMO1	Myeloid_OA,Lymphoid_OA
IFI16	Myeloid_OA,Lymphoid_OA
GTF2H1	Myeloid_OA,Lymphoid_OA
COP1	Myeloid_OA,Lymphoid_OA
CLK2	Myeloid_OA
TPT1	Myeloid_OA,Lymphoid_OA
PBK	Myeloid_OA,Lymphoid_OA
HTT	Myeloid_OA,Lymphoid_OA
HDAC1	Myeloid_OA,Lymphoid_AYA,Lymphoid_OA
CDKN1A	Myeloid_OA,Lymphoid_OA
HNRNPUL1	Myeloid_OA,Lymphoid_OA
WDR5	Myeloid_OA,Lymphoid_AYA,Lymphoid_OA
RBBP5	Myeloid_OA,Lymphoid_OA
ARIH2	Myeloid_OA,Lymphoid_OA
S100A6	Myeloid_OA,Lymphoid_OA
S100A2	Myeloid_OA,Lymphoid_OA
DROSHA	Myeloid_OA,Lymphoid_OA
EZH2	Myeloid_OA,Lymphoid_OA
ZRSR2P1	Myeloid_OA
U2AF2	Myeloid_OA
STIP1	Myeloid_OA,Lymphoid_AYA,Lymphoid_OA
SMAD2	Myeloid_OA,Lymphoid_OA
SFN	Myeloid_OA,Lymphoid_OA
HNRNPK	Myeloid_OA,Lymphoid_OA
CARNMT1	Myeloid_OA
ATXN1	Myeloid_OA
SRSF3	Myeloid_OA
SRPK1	Myeloid_OA,Lymphoid_OA
KDM1A	Myeloid_OA,Lymphoid_AYA,Lymphoid_OA
HSPB1	Myeloid_OA,Lymphoid_AYA,Lymphoid_OA
GSK3B	Myeloid_OA,Lymphoid_OA
CCT5	Myeloid_OA,Lymphoid_OA
WRN	Myeloid_OA,Lymphoid_OA
RING1	Myeloid_OA,Lymphoid_OA
RBPJ	Myeloid_OA,Lymphoid_OA
PPP2R5C	Myeloid_OA,Lymphoid_OA
NCOR2	Myeloid_OA,Lymphoid_OA
HTATSF1	Myeloid_OA
FBXO11	Myeloid_OA,Lymphoid_OA
DUSP26	Myeloid_OA,Lymphoid_OA
DNMT3L	Myeloid_OA,Lymphoid_OA
CHEK2	Myeloid_OA,Lymphoid_OA
BRCA2	Myeloid_OA,Lymphoid_OA
YWHAG	Myeloid_OA,Lymphoid_OA
SMG5	Myeloid_OA,Lymphoid_OA
PPIF	Myeloid_OA,Lymphoid_OA
PIK3R3	Myeloid_OA,Lymphoid_OA
JMJD6	Myeloid_OA,Lymphoid_OA
FBXW8	Myeloid_OA,Lymphoid_AYA,Lymphoid_OA
BAG2	Myeloid_OA,Lymphoid_OA
PPP2R1A	Myeloid_OA,Lymphoid_OA
OTUB1	Myeloid_OA,Lymphoid_OA
NUMB	Myeloid_OA,Lymphoid_OA
NOC2L	Myeloid_OA,Lymphoid_OA
CDK6	Myeloid_OA
SRSF1	Myeloid_OA
SF3B6	Myeloid_OA
S100B	Myeloid_OA,Lymphoid_OA
S100A1	Myeloid_OA,Lymphoid_OA
RYBP	Myeloid_OA,Lymphoid_OA
RUVBL1	Myeloid_OA,Lymphoid_OA
TAL1	Myeloid_OA
RFWD3	Myeloid_OA,Lymphoid_OA
PHB1	Myeloid_OA,Lymphoid_OA
H3-3A	Myeloid_OA,Lymphoid_OA
CDKN2A	Myeloid_OA,Lymphoid_OA
SYVN1	Myeloid_OA,Lymphoid_OA
IKBKB	Myeloid_OA,Lymphoid_OA
SETDB1	Myeloid_OA,Lymphoid_OA
CCDC106	Myeloid_OA,Lymphoid_OA
WT1	Myeloid_OA,Lymphoid_OA
PRKCD	Myeloid_OA,Lymphoid_OA
MKRN1	Myeloid_OA,Lymphoid_OA
IP6K2	Myeloid_OA,Lymphoid_OA
ETS2	Myeloid_OA,Lymphoid_OA
PRMT5	Myeloid_OA,Lymphoid_OA
MEOX2	Myeloid_OA,Lymphoid_OA
CXXC1	Myeloid_OA,Lymphoid_OA
ZNF420	Myeloid_OA,Lymphoid_OA
XPO1	Myeloid_OA,Lymphoid_OA
TP63	Myeloid_OA,Lymphoid_OA
SP1	Myeloid_OA,Lymphoid_OA
SOX4	Myeloid_OA,Lymphoid_OA
SIN3A	Myeloid_OA,Lymphoid_OA
TLE1	Myeloid_OA
RPS3	Myeloid_OA,Lymphoid_OA
NUAK1	Myeloid_OA,Lymphoid_OA
MAGEC2	Myeloid_OA,Lymphoid_OA
UHRF1	Myeloid_OA,Lymphoid_OA
CIR1	Myeloid_OA
AIMP2	Myeloid_OA,Lymphoid_OA
TOE1	Myeloid_OA,Lymphoid_OA
PSME3	Myeloid_OA,Lymphoid_OA
NRDC	Myeloid_OA,Lymphoid_OA
NR4A1	Myeloid_OA,Lymphoid_OA
PIAS1	Myeloid_OA,Lymphoid_OA
CSNK2A1	Myeloid_OA,Lymphoid_OA
ZNF417	Myeloid_OA
TRA2B	Myeloid_OA
YWHAZ	Myeloid_OA,Lymphoid_OA
UCHL1	Myeloid_OA,Lymphoid_OA
TNFAIP8L1	Myeloid_OA
TEPSIN	Myeloid_OA
TCF4	Myeloid_OA,Lymphoid_AYA,Lymphoid_OA
SRSF5	Myeloid_OA
SRRM4	Myeloid_OA
SPRED1	Myeloid_OA,Lymphoid_AYA
SNRNP35	Myeloid_OA
SNRPN	Myeloid_OA
SAFB	Myeloid_OA,Lymphoid_OA
VPS37C	Myeloid_OA
TEKT5	Myeloid_OA
TEAD4	Myeloid_OA
TEAD2	Myeloid_OA
SNRPC	Myeloid_OA
RNPS1	Myeloid_OA
REP15	Myeloid_OA
RBM17	Myeloid_OA
PMP22	Myeloid_OA,Lymphoid_OA
PEX26	Myeloid_OA,Lymphoid_OA
OLIG3	Myeloid_OA
OGT	Myeloid_OA,Lymphoid_OA
NPM1	Myeloid_OA,Lymphoid_OA
NFYB	Myeloid_OA,Lymphoid_OA
NFKBID	Myeloid_OA
NEK7	Myeloid_OA
NCL	Myeloid_OA,Lymphoid_OA
MLH1	Myeloid_OA
MAP1B	Myeloid_OA,Lymphoid_OA
LUC7L2	Myeloid_OA
LAMP2	Myeloid_OA,Lymphoid_AYA,Lymphoid_OA
KRT75	Myeloid_OA
KRT1	Myeloid_OA
KHDC4	Myeloid_OA
KAT8	Myeloid_OA,Lymphoid_OA
HGS	Myeloid_OA
GSN	Myeloid_OA,Lymphoid_AYA,Lymphoid_OA
GCC1	Myeloid_OA
FLNA	Myeloid_OA,Lymphoid_OA
FBXO17	Myeloid_OA
FAM222B	Myeloid_OA
EFHC2	Myeloid_OA
ZNF513	Myeloid_OA,Lymphoid_OA
WFS1	Myeloid_OA,Lymphoid_OA
SP100	Myeloid_OA,Lymphoid_OA
OTX1	Myeloid_OA,Lymphoid_OA
MDFI	Myeloid_OA,Lymphoid_OA
DLST	Myeloid_OA
CSF2RB	Myeloid_OA,Lymphoid_AYA
CEBPB	Myeloid_OA,Lymphoid_OA
CCNL1	Myeloid_OA
CCNK	Myeloid_OA
CBFB	Myeloid_OA
CASP6	Myeloid_OA,Lymphoid_AYA,Lymphoid_OA
CALR	Myeloid_OA
BCL2	Myeloid_OA,Lymphoid_OA
BAG4	Myeloid_OA
BAG3	Myeloid_OA
GOLGA6L9	Myeloid_OA
AP2B1	Myeloid_OA
AP1B1	Myeloid_OA
TK1	Myeloid_OA,Lymphoid_OA
SNIP1	Myeloid_OA,Lymphoid_AYA
HMGB2	Myeloid_OA
USP42	Myeloid_OA,Lymphoid_OA
S100P	Myeloid_OA,Lymphoid_OA
S100A5	Myeloid_OA,Lymphoid_OA
S100A11	Myeloid_OA,Lymphoid_OA
NOL3	Myeloid_OA,Lymphoid_OA
NFYA	Myeloid_OA,Lymphoid_OA
MT1A	Myeloid_OA,Lymphoid_OA
KAT5	Myeloid_OA,Lymphoid_AYA
HSPA1L	Myeloid_OA,Lymphoid_OA
FOXO3	Myeloid_OA,Lymphoid_AYA,Lymphoid_OA
ELF2	Myeloid_OA
CSE1L	Myeloid_OA,Lymphoid_OA
BRCA1	Myeloid_OA,Lymphoid_OA
TCP1	Myeloid_OA,Lymphoid_OA
STUB1	Myeloid_OA,Lymphoid_OA
SNW1	Myeloid_OA
SETD1A	Myeloid_OA,Lymphoid_OA
WWTR1	Myeloid_OA
RPL5	Myeloid_OA,Lymphoid_OA
OLA1	Myeloid_OA,Lymphoid_OA
OBSL1	Myeloid_OA,Lymphoid_OA
SH2B1	Myeloid_OA
ESR2	Myeloid_OA
DNAJC7	Myeloid_OA,Lymphoid_OA
DHX15	Myeloid_OA
CSNK2A2	Myeloid_OA,Lymphoid_OA
CFTR	Myeloid_OA,Lymphoid_OA
CCT7	Myeloid_OA,Lymphoid_OA
CCT6A	Myeloid_OA,Lymphoid_OA
CCT4	Myeloid_OA,Lymphoid_OA
CCT3	Myeloid_OA,Lymphoid_OA
CCT2	Myeloid_OA,Lymphoid_OA
CCDC8	Myeloid_OA,Lymphoid_OA
BAG5	Myeloid_OA,Lymphoid_OA
FOXK2	Myeloid_OA
UHRF2	Myeloid_OA,Lymphoid_OA
TRIM24	Myeloid_OA,Lymphoid_OA
U2AF1	Myeloid_OA
SRSF2	Myeloid_OA
SREBF2	Myeloid_OA,Lymphoid_OA
PPP1CC	Myeloid_OA,Lymphoid_OA
PIAS2	Myeloid_OA,Lymphoid_OA
NR0B2	Myeloid_OA,Lymphoid_OA
MED1	Myeloid_OA,Lymphoid_OA
LAMA4	Myeloid_OA,Lymphoid_OA
KMT2E	Myeloid_OA,Lymphoid_OA
MPL	Myeloid_OA
HUWE1	Myeloid_OA,Lymphoid_OA
DDX17	Myeloid_OA,Lymphoid_OA
CEBPZ	Myeloid_OA,Lymphoid_OA
BCR	Myeloid_OA,Lymphoid_OA
AXIN1	Myeloid_OA,Lymphoid_AYA,Lymphoid_OA
ATG7	Myeloid_OA,Lymphoid_OA
SUV39H1	Myeloid_OA
SF3B2	Myeloid_OA
PIAS4	Myeloid_OA,Lymphoid_OA
NKAP	Myeloid_OA
HIPK1	Myeloid_OA,Lymphoid_OA
FXR1	Myeloid_OA,Lymphoid_OA
BTBD2	Myeloid_OA,Lymphoid_OA
AKT1	Myeloid_OA
AIPL1	Myeloid_OA,Lymphoid_OA
MTOR	Lymphoid_AYA
SMARCC1	Lymphoid_AYA
PDGFRB	Lymphoid_AYA
RAF1	Lymphoid_AYA
TRRAP	Lymphoid_AYA
FBXW7	Lymphoid_AYA
EGFR	Lymphoid_AYA,Lymphoid_OA
SMARCD1	Lymphoid_AYA
ZBTB17	Lymphoid_AYA
IGF1R	Lymphoid_AYA
EP400	Lymphoid_AYA
GTF3C3	Lymphoid_AYA
CCAR2	Lymphoid_AYA
BRAF	Lymphoid_AYA
TERT	Lymphoid_AYA
TRIM32	Lymphoid_AYA
PBRM1	Lymphoid_AYA
TCF12	Lymphoid_AYA
SMARCC2	Lymphoid_AYA
MCM7	Lymphoid_AYA
DPF2	Lymphoid_AYA
FRS2	Lymphoid_AYA
EIF4EBP1	Lymphoid_AYA
ARID2	Lymphoid_AYA
EFTUD2	Lymphoid_AYA
CD33	Lymphoid_AYA
RPIA	Lymphoid_AYA
RIN1	Lymphoid_AYA
SMC4	Lymphoid_AYA
PRPF6	Lymphoid_AYA
LRPPRC	Lymphoid_AYA
FHL2	Lymphoid_AYA
ATXN10	Lymphoid_AYA
PIP5K1A	Lymphoid_AYA
KPNA4	Lymphoid_AYA
EPHA2	Lymphoid_AYA
INSR	Lymphoid_AYA
SYT-SSX1	Lymphoid_AYA
HADHB	Lymphoid_AYA
GAB2	Lymphoid_AYA
TRIP12	Lymphoid_AYA
CCKBR	Lymphoid_AYA
RRAGC	Lymphoid_AYA
SIN3B	Lymphoid_AYA
MET	Lymphoid_AYA
ACTL6A	Lymphoid_AYA
SS18	Lymphoid_AYA
PXN	Lymphoid_AYA
PDCD1	Lymphoid_AYA
DPF3	Lymphoid_AYA
ERBB2	Lymphoid_AYA
CDK4	Lymphoid_AYA
BIN1	Lymphoid_AYA
DEPTOR	Lymphoid_AYA
DDR1	Lymphoid_AYA
ERBB4	Lymphoid_AYA
PREX1	Lymphoid_AYA
RGL3	Lymphoid_AYA
RAP1GDS1	Lymphoid_AYA
XPO5	Lymphoid_AYA
UBTF	Lymphoid_AYA
UBQLN1	Lymphoid_AYA
TRIM28	Lymphoid_AYA
TOP1	Lymphoid_AYA
TARDBP	Lymphoid_AYA
SNRNP200	Lymphoid_AYA
SMC2	Lymphoid_AYA
SH3GLB1	Lymphoid_AYA
RFC4	Lymphoid_AYA
PRPF40A	Lymphoid_AYA
POLR2B	Lymphoid_AYA
POLE	Lymphoid_AYA
PDS5B	Lymphoid_AYA
OPA1	Lymphoid_AYA
NUP93	Lymphoid_AYA
NUP133	Lymphoid_AYA
NOP56	Lymphoid_AYA
MYBBP1A	Lymphoid_AYA
MSH6	Lymphoid_AYA
MMS19	Lymphoid_AYA
MARS1	Lymphoid_AYA
MAP7D1	Lymphoid_AYA
IQGAP2	Lymphoid_AYA
IPO9	Lymphoid_AYA
IPO4	Lymphoid_AYA
TCF3	Lymphoid_AYA
SDCBP	Lymphoid_AYA
RAB7A	Lymphoid_AYA
MYF5	Lymphoid_AYA
MSGN1	Lymphoid_AYA
LMO4	Lymphoid_AYA
KRTAP26-1	Lymphoid_AYA
HOXA1	Lymphoid_AYA
HNRNPC	Lymphoid_AYA
HELLS	Lymphoid_AYA
HDAC2	Lymphoid_AYA
GUCD1	Lymphoid_AYA
GTF2B	Lymphoid_AYA
GMNN	Lymphoid_AYA
FRS3	Lymphoid_AYA
FAM74A1	Lymphoid_AYA
DR1	Lymphoid_AYA
DMWD	Lymphoid_AYA
DDX24	Lymphoid_AYA
DDX20	Lymphoid_AYA
CTPS1	Lymphoid_AYA
CREB5	Lymphoid_AYA
COPG1	Lymphoid_AYA
CDH1	Lymphoid_AYA
CCK	Lymphoid_AYA
CBX5	Lymphoid_AYA
C22orf39	Lymphoid_AYA
BOLA2-SMG1P6	Lymphoid_AYA
ATP2A2	Lymphoid_AYA
ARHGEF2	Lymphoid_AYA
ANKS1A	Lymphoid_AYA
AKT1S1	Lymphoid_AYA
ACACA	Lymphoid_AYA
SKP1	Lymphoid_AYA
PSMC3	Lymphoid_AYA
KPNA2	Lymphoid_AYA
GCN1	Lymphoid_AYA
SPAG5	Lymphoid_AYA
RAB1A	Lymphoid_AYA
RASSF2	Lymphoid_AYA
H2AX	Lymphoid_AYA
GAB1	Lymphoid_AYA
G3BP1	Lymphoid_AYA
FANCA	Lymphoid_AYA
CIP2A	Lymphoid_AYA
CDC73	Lymphoid_AYA
CAT	Lymphoid_AYA
SMARCB1	Lymphoid_AYA
RRAGA	Lymphoid_AYA
VCAM1	Lymphoid_AYA
PHF10	Lymphoid_AYA
TUBA4A	Lymphoid_AYA
SUCLG1	Lymphoid_AYA
SQOR	Lymphoid_AYA
SMARCA5	Lymphoid_AYA
SDF4	Lymphoid_AYA
RPP30	Lymphoid_AYA
PTPN14	Lymphoid_AYA
PSMD2	Lymphoid_AYA
PSMC1	Lymphoid_AYA
PSMA3	Lymphoid_AYA
PSMA1	Lymphoid_AYA
POLR2A	Lymphoid_AYA
NONO	Lymphoid_AYA
NDUFS2	Lymphoid_AYA
LMNA	Lymphoid_AYA
LEPR	Lymphoid_AYA
LAMTOR5	Lymphoid_AYA
LAMTOR4	Lymphoid_AYA
LAMTOR1	Lymphoid_AYA
IGF2BP2	Lymphoid_AYA
GTF3C4	Lymphoid_AYA
GANAB	Lymphoid_AYA
EEF1G	Lymphoid_AYA
DPM1	Lymphoid_AYA
ATP5MF	Lymphoid_AYA
ATP5F1C	Lymphoid_AYA
ARID1A	Lymphoid_AYA
AKAP8	Lymphoid_AYA
NCOR1	Lymphoid_AYA
SIRT6	Lymphoid_AYA
RHOA	Lymphoid_AYA
FGFR4	Lymphoid_AYA
FGFR2	Lymphoid_AYA
CEP57	Lymphoid_AYA
CD244	Lymphoid_AYA
BRD3	Lymphoid_AYA
ARL6IP5	Lymphoid_AYA
ARID1B	Lymphoid_AYA
MIF4GD	Lymphoid_AYA
LARS1	Lymphoid_AYA
BECN1	Lymphoid_OA
BAX	Lymphoid_OA
IRF3	Lymphoid_OA
BID	Lymphoid_OA
BIK	Lymphoid_OA
BBC3	Lymphoid_OA
BAD	Lymphoid_OA
SPOP	Lymphoid_OA
TLR4	Lymphoid_OA
NLRP1	Lymphoid_OA
TLR2	Lymphoid_OA
SGTA	Lymphoid_OA
TNFRSF13B	Lymphoid_OA
NCOA1	Lymphoid_OA
AMBRA1	Lymphoid_OA
TP53BP2	Lymphoid_OA
PAXIP1	Lymphoid_OA
ABCG2	Lymphoid_OA
RPS19	Lymphoid_OA
AR	Lymphoid_OA
SARM1	Lymphoid_OA
IRF5	Lymphoid_OA
H4C1	Lymphoid_OA
BAK1	Lymphoid_OA
TXN	Lymphoid_OA
CREB1	Lymphoid_OA
IRAK2	Lymphoid_OA
DOCK8	Lymphoid_OA
IFNAR2	Lymphoid_OA
FADD	Lymphoid_OA
GATA2	Lymphoid_OA
CTNNB1	Lymphoid_OA
ZBTB1	Lymphoid_OA
TFPT	Lymphoid_OA
NHLH1	Lymphoid_OA
ZNF35	Lymphoid_OA
SPOPL	Lymphoid_OA
RNF4	Lymphoid_OA
NTAQ1	Lymphoid_OA
IRAK4	Lymphoid_OA
HEXIM2	Lymphoid_OA
FXR2	Lymphoid_OA
FH	Lymphoid_OA
NCOA6	Lymphoid_OA
FOXO1	Lymphoid_OA
SGTB	Lymphoid_OA
BEND7	Lymphoid_OA
SOD1	Lymphoid_OA
BANP	Lymphoid_OA
PRKCA	Lymphoid_OA
SMAD3	Lymphoid_OA
SIAH1	Lymphoid_OA
FOXP3	Lymphoid_OA
MYB	Lymphoid_OA
BMX	Lymphoid_OA
PMAIP1	Lymphoid_OA
CISD2	Lymphoid_OA
PAGR1	Lymphoid_OA
KDM6A	Lymphoid_OA
KLF15	Lymphoid_OA
STAP2	Lymphoid_OA
HDAC6	Lymphoid_OA
CYTH2	Lymphoid_OA
TBX21	Lymphoid_OA
BCAP31	Lymphoid_OA
FKBP8	Lymphoid_OA
